6,10
##########
#    #   #
# ##   #S#
#S########
#       E#
##########
